50 53
15 11 11 11 11 11 11 11 11 11 11 11 11 11 11 11 11 11 11 11 11 11 11 11 11 11 11 11 11 11 11 11 11 11 11 11 11 11 11 11 11 11 11 11 11 11 11 11 11 11
15 0 0 0 0 0 0 0 0 0 0 0 0 0 0 0 0 0 0 0 0 0 0 0 0 0 0 0 0 0 0 0 0 0 0 0 0 0 0 0 0 0 0 0 0 0 0 0 0 11
15 0 0 0 0 0 0 0 0 0 0 0 0 0 0 0 0 0 0 0 0 0 0 0 0 0 0 0 0 0 0 0 0 0 0 0 0 0 0 0 0 0 0 0 0 0 0 0 0 11
15 0 0 11 11 11 11 11 11 11 11 11 11 11 11 11 11 11 11 11 11 11 11 11 11 11 11 11 11 11 11 11 11 11 11 11 11 11 11 11 11 11 11 11 11 11 11 0 0 11
15 0 0 11 14 14 0 0 0 0 0 0 0 14 14 0 14 14 14 14 0 0 0 11 0 0 11 0 0 0 0 0 0 0 0 0 0 0 0 0 0 0 14 0 0 0 0 0 0 11
15 0 0 11 0 0 0 14 0 0 14 0 0 0 0 0 0 0 0 0 0 14 0 11 0 0 11 0 14 14 14 0 14 0 14 14 14 14 14 14 14 0 14 0 14 14 14 14 14 11
15 0 0 11 0 14 14 14 14 0 14 14 14 14 14 14 14 14 0 14 14 14 0 11 0 0 11 0 14 14 14 0 14 0 0 0 0 0 0 0 14 0 0 0 14 0 14 0 0 11
15 0 0 11 0 0 0 14 0 0 14 0 0 0 14 14 0 14 0 14 0 0 0 0 0 0 11 0 0 0 0 0 14 14 14 0 14 14 14 14 14 0 14 0 14 0 14 0 0 11
15 0 0 11 0 14 0 14 14 0 14 0 14 0 0 0 0 14 0 14 0 14 14 11 0 0 11 14 14 14 14 0 0 0 0 0 14 0 0 0 0 0 14 0 14 0 14 0 0 11
15 0 0 11 0 14 0 14 14 0 14 0 14 0 14 14 14 14 0 0 0 0 0 11 0 0 11 0 0 0 14 14 14 0 0 0 14 0 14 0 14 14 14 0 14 0 14 0 0 11
15 0 0 11 0 14 0 14 0 0 14 0 14 0 14 0 0 0 0 14 14 14 0 11 0 0 11 0 14 0 14 0 0 0 0 0 14 0 14 0 0 0 14 0 0 0 14 0 0 11
15 0 0 11 0 14 0 14 0 14 14 0 0 0 14 0 14 14 0 0 0 14 0 11 0 0 11 0 14 0 14 0 14 14 14 14 14 0 14 0 14 0 14 14 14 14 14 0 0 11
15 0 0 11 0 14 0 14 0 14 0 0 14 0 14 14 14 14 14 14 0 14 0 11 0 0 11 0 14 0 14 0 0 0 0 0 0 0 14 0 14 0 14 0 0 0 14 0 0 11
15 0 0 11 0 14 0 14 0 14 0 0 14 0 0 0 14 0 0 14 0 14 0 11 0 0 11 0 14 0 14 0 14 14 14 14 14 14 14 0 14 0 14 0 14 0 14 0 0 11
15 0 0 11 0 14 0 14 0 14 0 0 14 0 14 0 14 14 0 14 0 14 0 0 0 0 0 0 14 0 14 0 0 0 0 0 0 0 0 0 14 0 14 0 14 0 14 0 0 11
15 0 0 11 0 14 14 14 0 14 0 0 14 0 14 0 14 14 0 14 14 14 14 11 11 11 11 14 14 0 14 0 14 14 14 14 14 14 0 14 14 0 14 0 14 0 14 0 0 11
15 0 0 11 0 14 0 0 0 14 0 0 14 14 14 14 14 0 0 0 0 0 0 11 0 0 11 0 0 0 0 0 0 0 14 0 0 0 0 0 14 0 14 0 14 0 14 0 0 11
15 0 0 11 0 14 0 14 14 14 0 14 14 0 0 0 0 0 11 11 11 11 0 11 0 0 11 11 11 11 11 11 0 0 0 0 0 14 14 14 14 0 14 0 14 0 14 0 0 11
15 0 0 11 0 14 0 14 14 0 0 0 0 0 11 11 11 11 11 0 11 0 0 0 0 0 0 0 0 11 0 11 11 11 11 11 0 0 0 0 14 0 14 0 14 0 0 0 0 11
15 0 0 11 0 0 0 0 0 0 11 11 11 11 11 0 0 0 0 0 11 11 11 11 0 0 11 11 11 11 0 0 0 0 0 11 11 11 11 11 11 0 0 0 11 11 11 0 0 11
15 15 15 15 15 15 15 11 11 11 11 0 0 0 0 0 0 0 0 0 0 0 0 14 0 0 14 0 0 0 0 0 0 0 0 0 0 0 0 11 11 11 11 0 0 0 11 0 0 11
15 0 0 0 0 0 15 0 0 0 0 0 0 0 0 0 0 0 14 14 0 0 0 14 0 0 14 0 0 11 0 0 0 0 0 0 11 0 0 0 0 0 11 11 11 0 11 0 0 11
15 0 0 0 0 0 15 0 0 0 14 14 0 0 14 14 0 0 14 14 0 0 14 14 0 0 14 14 0 0 0 11 0 14 14 0 11 0 0 0 0 0 0 11 11 11 11 0 0 11
15 0 0 0 0 0 15 15 0 0 14 14 0 0 14 14 0 0 0 0 0 0 14 0 0 0 0 14 0 0 0 11 0 14 14 0 11 0 0 0 0 0 11 11 11 11 11 0 0 11
15 0 0 0 0 0 0 15 0 0 0 0 0 0 0 0 0 0 0 14 14 0 0 0 0 0 0 0 0 0 0 11 0 0 0 0 11 0 14 14 0 0 11 0 0 11 11 0 0 11
15 0 0 0 0 0 0 0 0 0 0 0 0 0 0 0 0 0 0 14 14 0 0 0 0 0 0 0 0 0 0 0 0 0 0 0 0 0 0 14 14 14 14 14 0 0 11 0 0 11
15 0 0 0 0 0 0 0 0 0 0 0 0 0 0 0 0 0 0 0 0 0 0 0 0 0 0 0 0 0 0 0 0 0 0 0 0 0 0 0 0 0 0 0 0 0 11 s,W 0 11
15 0 0 0 0 0 0 0 0 0 0 0 0 0 0 0 0 0 0 14 14 0 0 0 0 0 0 0 0 0 0 0 0 0 0 0 0 0 0 14 14 14 14 14 0 0 11 0 0 11
15 0 0 0 0 0 0 15 0 0 0 0 0 0 0 0 0 0 0 14 14 0 0 0 0 0 0 0 0 0 0 11 0 0 0 0 11 0 14 14 0 0 11 0 0 11 11 0 0 11
15 0 0 0 0 0 15 15 0 0 14 14 0 0 14 14 0 0 0 0 0 0 14 0 0 0 0 14 0 0 0 11 0 14 14 0 11 0 0 0 0 0 11 11 11 11 11 0 0 11
15 0 0 0 0 0 15 0 0 0 14 14 0 0 14 14 0 0 14 14 0 0 14 14 0 0 14 14 0 0 0 11 0 14 14 0 11 0 0 0 0 0 0 11 11 11 11 0 0 11
15 0 0 0 0 0 15 0 0 0 0 0 0 0 0 0 0 0 14 14 0 0 0 14 0 0 14 0 0 0 0 11 0 0 0 0 11 0 0 0 0 0 11 11 11 0 11 0 0 11
15 15 15 15 15 15 15 11 11 11 11 0 0 0 0 0 0 0 0 0 0 0 0 14 0 0 14 0 0 0 0 0 0 0 0 0 0 0 0 11 11 11 11 0 0 0 11 0 0 11
15 0 0 11 0 0 0 0 0 0 11 11 11 11 11 0 0 0 0 0 11 11 11 11 0 0 11 11 11 11 0 0 0 0 0 11 11 11 11 11 0 0 0 0 0 0 11 0 0 11
15 0 0 11 0 14 14 0 0 0 0 0 0 0 11 11 11 11 11 11 11 0 0 0 0 0 0 0 0 11 11 11 11 11 11 11 0 0 0 0 0 0 0 0 0 0 11 0 0 11
15 0 0 11 0 14 14 0 0 0 0 14 0 0 14 0 0 0 11 11 11 11 11 11 0 0 11 11 11 11 11 11 0 0 0 0 14 0 0 0 0 0 0 0 0 0 11 0 0 11
15 0 0 11 0 0 0 0 0 0 0 14 14 0 14 0 0 0 0 0 0 0 0 11 0 0 11 0 0 0 0 0 0 0 0 14 14 14 0 0 0 0 0 0 0 0 11 0 0 11
15 0 0 11 14 0 0 0 0 0 0 0 14 0 0 0 0 0 0 0 0 0 0 11 0 0 11 0 0 11 14 14 0 0 14 14 14 14 14 0 0 14 14 0 0 0 11 0 0 11
15 0 0 11 14 0 14 14 0 0 0 0 14 14 0 14 14 0 0 0 0 0 0 11 0 0 11 0 0 0 0 14 14 14 14 0 0 0 14 14 14 14 0 0 0 0 11 0 0 11
15 0 0 11 14 0 14 14 0 0 0 0 0 14 14 14 0 0 0 0 0 0 0 11 0 0 11 0 0 0 0 0 0 0 0 0 0 0 0 0 0 0 0 0 0 14 11 0 0 11
15 0 0 11 14 0 0 0 0 0 0 0 0 0 0 0 0 0 0 0 0 0 0 11 0 0 11 0 0 0 0 0 0 0 0 14 0 14 0 0 0 0 0 0 14 14 11 0 0 11
15 0 0 11 14 0 0 0 0 0 0 0 0 0 0 0 0 0 0 0 0 0 0 0 0 0 0 0 0 0 0 0 0 0 14 14 0 14 14 0 0 0 0 0 14 14 11 0 0 11
15 0 0 11 14 0 14 14 0 0 0 0 0 0 0 0 0 0 0 0 0 0 0 0 0 0 0 0 0 0 0 0 0 0 14 14 0 14 14 0 0 0 0 0 14 14 11 0 0 11
15 0 0 11 14 0 14 14 0 0 0 0 0 14 14 14 0 0 0 0 0 0 0 11 0 0 11 0 0 0 0 0 0 0 0 14 0 14 0 0 0 0 0 0 14 14 11 0 0 11
15 0 0 11 14 0 0 0 0 0 0 0 14 14 0 14 14 0 0 0 0 0 0 11 0 0 11 0 0 0 0 0 0 0 0 0 0 0 0 0 0 0 0 0 0 14 11 0 0 11
15 0 0 11 14 0 0 0 0 0 0 0 14 0 0 0 0 0 0 0 0 0 0 11 0 0 11 0 0 0 0 14 14 14 14 0 0 0 14 14 14 14 0 0 0 0 11 0 0 11
15 0 0 11 0 14 14 0 0 0 0 14 14 0 14 0 0 0 0 0 0 0 0 11 0 0 11 0 0 0 14 14 0 0 14 14 14 14 14 0 0 14 14 0 0 0 11 0 0 11
15 0 0 11 0 14 14 0 0 0 0 14 0 0 14 0 0 0 0 0 0 0 0 11 0 0 11 14 14 0 0 0 0 0 0 0 14 0 0 0 0 0 0 0 14 14 11 0 0 11
15 0 0 11 0 0 0 0 0 0 0 0 0 0 0 0 0 0 0 0 0 0 0 11 0 0 11 0 14 14 14 0 0 14 14 14 0 14 14 14 0 0 14 14 14 0 11 0 0 11
15 0 0 11 11 11 11 11 11 11 11 11 11 11 11 11 11 11 11 11 11 11 11 11 0 0 11 11 11 11 11 11 11 11 11 11 11 11 11 11 11 11 11 11 11 11 11 0 0 11
15 0 0 0 0 0 0 0 0 0 0 0 0 0 0 0 0 0 0 0 0 0 0 0 0 0 0 0 0 0 0 0 0 0 0 0 0 0 0 0 0 0 0 0 0 0 0 0 0 11
15 0 0 0 0 0 0 0 0 0 0 0 0 0 0 0 0 0 0 0 0 0 0 0 0 0 0 0 0 0 0 0 0 0 0 0 0 0 0 0 0 0 0 0 0 0 0 0 0 11
15 11 11 11 11 11 11 11 11 11 11 11 11 11 11 11 11 11 11 11 11 11 11 11 11 11 11 11 11 11 11 11 11 11 11 11 11 11 11 11 11 11 11 11 11 11 11 11 11 11
