36 15
1 1 1 1 1 1 1 1 1 1 1 1 1 1 1 1 1 1 1 1 1 1 1 1 1 1 1 1 1 1 1 1 1 1 1 1
1 0 0 0 0 0 0 0 0 0 0 0 0 0 0 0 0 0 0 0 0 0 0 0 0 0 0 0 0 0 0 0 0 0 0 1
1 0 0 0 0 0 0 0 0 0 0 0 0 0 0 0 0 0 0 0 0 0 0 0 0 0 0 0 0 0 0 0 0 0 0 1
1 0 0 6 6 6 6 6 6 0 0 6 0 6 6 6 6 0 6 6 6 6 6 0 6 0 0 6 6 6 6 6 6 0 0 1
1 0 0 0 0 0 0 0 6 0 0 6 0 0 0 0 0 0 0 0 0 0 0 0 6 0 0 6 0 0 0 0 0 0 0 1
1 0 0 0 6 6 6 0 6 0 0 6 0 6 6 6 6 0 6 6 6 6 6 0 6 0 0 6 0 6 6 6 0 0 0 1
1 0 0 0 0 0 0 0 6 0 0 6 0 0 0 0 0 0 0 0 0 0 0 0 6 0 0 6 0 0 0 0 0 0 0 1
1 0 0 0 6 6 6 0 6 0 0 6 0 6 6 6 6 0 6 6 6 6 6 0 6 0 0 6 0 6 6 6 0 0 0 1
1 0 0 0 0 0 0 0 6 0 0 6 0 0 0 0 0 0 0 0 0 0 0 0 6 0 0 6 0 0 0 0 0 0 0 1
1 0 0 0 6 6 6 0 6 0 0 6 0 6 6 6 6 0 6 6 6 6 6 0 6 0 0 6 0 6 6 6 0 0 0 1
1 0 0 0 0 0 0 0 6 0 0 6 0 0 0 0 0 0 0 0 0 0 0 0 6 0 0 6 0 0 0 0 0 0 0 1
1 0 0 6 6 6 6 6 6 0 0 6 0 6 6 6 6 0 6 6 6 6 6 0 6 0 0 6 6 6 6 6 6 0 0 1
1 0 0 0 0 0 0 0 0 0 0 0 0 0 0 0 0 0 0 0 0 0 0 0 0 0 0 0 0 0 0 0 0 0 0 1
1 0 0 0 0 0 0 0 0 0 0 0 0 0 0 0 0 s 0 0 0 0 0 0 0 0 0 0 0 0 0 0 0 0 0 1
1 1 1 1 1 1 1 1 1 1 1 1 1 1 1 1 1 1 1 1 1 1 1 1 1 1 1 1 1 1 1 1 1 1 1 1
